Language	Value
Aari	 OV and NAdj
Abipón	 Other
Abkhaz	 OV and NAdj
Abui	 OV and NAdj
Abun	 VO and NAdj
Acehnese	 Other
Achagua	 VO and NAdj
Achang	 Other
Acholi	 VO and NAdj
Acoma	 Other
Adang	 OV and NAdj
Adioukrou	 VO and NAdj
Adyghe (Abzakh)	 OV and NAdj
Adynyamathanha	 Other
Adzera	 VO and NAdj
Aekyom	 OV and NAdj
Agarabi	 OV and AdjN
Aghem	 VO and NAdj
Agta (Central)	 VO and AdjN
Agta (Dupaningan)	 VO and AdjN
Ainu	 OV and AdjN
Aja	 VO and AdjN
Ajagbe	 Other
Akan	 VO and NAdj
Akha	 OV and NAdj
Alamblak	 OV and AdjN
Alawa	 Other
Albanian	 VO and NAdj
Alsea	 VO and AdjN
Alune	 VO and NAdj
Alyawarra	 OV and NAdj
Ama	 Other
Amahuaca	 OV and NAdj
Amanab	 OV and NAdj
Amara	 VO and NAdj
Ambae (Lolovoli Northeast)	 VO and NAdj
Ambai	 VO and NAdj
Ambulas	 OV and AdjN
Amdo (Themchen)	 Other
Amele	 OV and NAdj
Amharic	 OV and AdjN
Amis	 VO and AdjN
Amo	 VO and NAdj
Anamuxra	 OV and NAdj
Anejom	 VO and NAdj
Anêm	 VO and NAdj
Angami	 OV and NAdj
Angas	 VO and NAdj
Anggor	 OV and NAdj
Anguthimri	 OV and NAdj
//Ani	 Other
Anong	 OV and NAdj
Anufo	 VO and NAdj
Anyi	 VO and NAdj
Anywa	 Other
Ao	 OV and NAdj
Apalaí	 OV and NAdj
Apatani	 OV and NAdj
Apinayé	 OV and NAdj
Apurinã	 Other
Arabana	 OV and NAdj
Arabic (Egyptian)	 VO and NAdj
Arabic (Gulf)	 VO and NAdj
Arabic (Iraqi)	 VO and NAdj
Arabic (Kuwaiti)	 VO and NAdj
Arabic (Modern Standard)	 VO and NAdj
Arabic (Moroccan)	 VO and NAdj
Arabic (Syrian)	 VO and NAdj
Araona	 OV and NAdj
Arapesh (Abu)	 VO and NAdj
Arapesh (Mountain)	 VO and AdjN
Arbore	 OV and NAdj
Archi	 OV and AdjN
Armenian (Eastern)	 Other
Armenian (Western)	 OV and AdjN
Arop-Lokep	 VO and NAdj
Arosi	 VO and NAdj
Arrernte (Mparntwe)	 OV and NAdj
Asmat	 OV and NAdj
Assamese	 OV and AdjN
Atacameño	 OV and NAdj
Atayal	 Other
Athpare	 OV and AdjN
Au	 VO and NAdj
Avar	 OV and AdjN
Avokaya	 Other
Awa	 OV and AdjN
Awa Pit	 OV and AdjN
Awtuw	 OV and NAdj
Awyi	 OV and NAdj
Ayiwo	 VO and NAdj
Aymara (Central)	 OV and AdjN
Ayomán	 VO and NAdj
Azerbaijani	 OV and AdjN
Babole	 VO and NAdj
Babungo	 VO and NAdj
Bachamal	 Other
Badimaya	 OV and NAdj
Bafut	 VO and NAdj
Bagirmi	 VO and NAdj
Baham	 OV and NAdj
Bai	 VO and AdjN
Bajau (Sama)	 VO and NAdj
Bajau (West Coast)	 VO and NAdj
Baka (in Cameroon)	 VO and AdjN
Baka (in South Sudan)	 VO and AdjN
Bakueri	 VO and NAdj
Balanta	 VO and NAdj
Bali-Vitu	 VO and NAdj
Balti	 OV and AdjN
Bambara	 OV and NAdj
Bandjalang	 OV and AdjN
Bangime	 OV and NAdj
Bankon	 VO and NAdj
Banoni	 VO and NAdj
Baoulé	 VO and NAdj
Baragaunle	 OV and NAdj
Barai	 OV and NAdj
Barambu	 VO and AdjN
Barasano	 Other
Baré	 VO and NAdj
Bari	 VO and NAdj
Barupu	 OV and NAdj
Baruya	 OV and NAdj
Basaá	 VO and NAdj
Basari	 OV and NAdj
Bashkir	 OV and AdjN
Basque	 OV and NAdj
Batak (Karo)	 VO and NAdj
Batak (Toba)	 VO and NAdj
Baure	 VO and NAdj
Bawm	 OV and NAdj
Beja	 Other
Belhare	 OV and AdjN
Bella Coola	 VO and AdjN
Belorussian	 Other
Bena-Lulua	 VO and NAdj
Berber (Chaouia)	 VO and NAdj
Berber (Figuig)	 VO and NAdj
Berber (Middle Atlas)	 VO and NAdj
Berber (Rif)	 VO and NAdj
Beria	 OV and NAdj
Berta	 VO and NAdj
Bhojpuri	 OV and AdjN
Bhumij	 OV and AdjN
Biak	 VO and NAdj
Bidiya	 VO and NAdj
Bikol	 Other
Bila	 VO and NAdj
Bilin	 OV and NAdj
Biloxi	 OV and NAdj
Bilua	 VO and AdjN
Binandere	 OV and NAdj
Bini	 VO and NAdj
Bininj Gun-Wok	 Other
Biri	 VO and AdjN
Birom	 VO and NAdj
Bisu	 OV and NAdj
Blackfoot	 VO and AdjN
Bodo	 OV and AdjN
Boko	 OV and NAdj
Bongo	 Other
Bongu	 OV and NAdj
Bontok	 Other
Bori	 Other
Brao	 VO and NAdj
Breton	 VO and NAdj
Bribri	 OV and NAdj
Brokskat	 OV and AdjN
Bubi	 VO and NAdj
Budu	 VO and NAdj
Buduma	 VO and NAdj
Bugun	 Other
Buin	 OV and NAdj
Bulgarian	 VO and AdjN
Buma	 VO and NAdj
Bunan	 OV and NAdj
Bunuba	 Other
Bunu (Younuo)	 VO and NAdj
Burarra	 Other
Buriat	 OV and AdjN
Burmese	 OV and NAdj
Buru	 VO and NAdj
Burunge	 VO and NAdj
Burushaski	 OV and AdjN
Busa	 OV and NAdj
Bushoong	 VO and NAdj
Byansi	 OV and AdjN
Cahuilla	 OV and AdjN
Cakchiquel	 VO and AdjN
Campa (Axininca)	 VO and NAdj
Camsá	 Other
Canela	 OV and NAdj
Cantonese	 VO and AdjN
Carib	 OV and AdjN
Carib (De'kwana)	 OV and NAdj
Cashibo	 OV and NAdj
Catalan	 VO and NAdj
Catawba	 OV and NAdj
Cavineña	 Other
Cayapa	 OV and AdjN
Cayuvava	 VO and AdjN
Cèmuhî	 VO and NAdj
Chácobo	 OV and NAdj
Chaga	 VO and NAdj
Chaha	 OV and AdjN
Chai	 Other
Chambri	 OV and NAdj
Cham (Eastern)	 VO and NAdj
Chamorro	 VO and AdjN
Cham (Western)	 VO and NAdj
Chang	 Other
Chantyal	 OV and AdjN
Chatino (Sierra Occidental)	 VO and NAdj
Chatino (Yaitepec)	 VO and NAdj
Chaudangsi	 OV and AdjN
Chechen	 OV and AdjN
Chemehuevi	 Other
Chepang	 OV and AdjN
Cherokee	 OV and AdjN
Chichewa	 VO and NAdj
Chimariko	 OV and NAdj
Chinantec (Comaltepec)	 VO and NAdj
Chinantec (Lealao)	 VO and NAdj
Chinantec (Palantla)	 VO and NAdj
Chinantec (Quiotepec)	 VO and NAdj
Chin (Mara)	 OV and NAdj
Chinook (Lower)	 VO and AdjN
Chin (Siyin)	 Other
Chin (Tiddim)	 OV and NAdj
Chipaya	 OV and AdjN
Chitimacha	 OV and NAdj
Choctaw	 Other
Cholón	 OV and AdjN
Chontal (Huamelultec Oaxaca)	 VO and AdjN
Chontal Maya	 VO and AdjN
Chrau	 VO and NAdj
Chukchi	 OV and AdjN
Chuvash	 OV and AdjN
Cocama	 VO and NAdj
Comanche	 OV and AdjN
Coos (Hanis)	 Other
Coptic	 VO and NAdj
Cora	 VO and NAdj
Cornish	 VO and NAdj
Crow	 OV and NAdj
Cubeo	 OV and AdjN
Cuiba	 OV and NAdj
Cuica	 Other
Cupeño	 OV and NAdj
Czech	 VO and AdjN
Dadjriwalé	 Other
Daga	 OV and NAdj
Dagaare	 VO and NAdj
Dagbani	 VO and NAdj
Dagur	 OV and AdjN
Damana	 Other
Dan	 OV and NAdj
Danish	 VO and AdjN
Dargwa	 OV and AdjN
Darma	 OV and AdjN
Dâw	 OV and NAdj
Day	 VO and NAdj
Degema	 Other
Desano	 OV and AdjN
Deuri	 OV and AdjN
Dhaasanac	 OV and NAdj
Dhargari	 Other
Dhimal	 OV and AdjN
Didinga	 VO and NAdj
Diegueño (Mesa Grande)	 Other
Digaro	 OV and NAdj
Dimasa	 OV and NAdj
Dime	 OV and NAdj
Dinka	 Other
Diola-Fogny	 VO and NAdj
Diyari	 OV and NAdj
Djambarrpuyngu	 Other
Djaru	 Other
Djinang	 Other
Djingili	 OV and NAdj
Dla (Menggwa)	 Other
Dla (Proper)	 Other
Domaaki	 OV and AdjN
Domari	 VO and AdjN
Dongo	 Other
Dong (Southern)	 VO and NAdj
Donno So	 OV and NAdj
Doyayo	 VO and NAdj
Drehu	 VO and NAdj
Duala	 VO and NAdj
Duka	 VO and NAdj
Dulong	 Other
Duma	 VO and NAdj
Dumi	 OV and AdjN
Dumo	 OV and NAdj
Duna	 OV and NAdj
Dutch	 Other
Dyirbal	 OV and NAdj
Edolo	 OV and NAdj
Efate (South)	 VO and NAdj
Ega	 VO and NAdj
Eipo	 OV and AdjN
Emberá (Northern)	 OV and NAdj
Émérillon	 OV and NAdj
Emmi	 Other
Enets	 OV and AdjN
Engenni	 VO and NAdj
Enggano	 VO and NAdj
English	 VO and AdjN
Epena Pedee	 OV and NAdj
Erromangan	 VO and NAdj
Ese Ejja	 OV and NAdj
Esmeraldeño	 Other
Estonian	 VO and AdjN
Even	 OV and AdjN
Evenki	 OV and AdjN
Ewe	 VO and NAdj
Ewondo	 VO and NAdj
Fasu	 OV and NAdj
Fijian	 VO and NAdj
Finnish	 VO and AdjN
Foe	 OV and NAdj
Folopa	 Other
Fongbe	 VO and NAdj
Fore	 OV and AdjN
French	 VO and NAdj
Frisian	 Other
Fulfulde (Adamawa)	 VO and NAdj
Fulfulde (Nigerian)	 VO and NAdj
Fulniô	 OV and NAdj
Fur	 OV and NAdj
Futuna-Aniwa	 VO and NAdj
Fyem	 VO and NAdj
Gã	 VO and NAdj
Ga'anda	 VO and NAdj
Gadsup	 OV and AdjN
Gaelic (Scots)	 VO and NAdj
Gahuku	 Other
Galo	 OV and AdjN
Gamo	 OV and AdjN
Garífuna	 VO and NAdj
Garo	 OV and NAdj
Garrwa	 VO and NAdj
Gavião	 OV and NAdj
Gbaya (Northwest)	 VO and AdjN
Gbeya Bossangoa	 VO and AdjN
Gela	 VO and NAdj
Gelao	 VO and NAdj
Georgian	 OV and AdjN
German	 Other
Gidabal	 Other
Gimira	 Other
Gitksan	 Other
Goajiro	 VO and NAdj
Godoberi	 OV and AdjN
Goemai	 VO and NAdj
Gokana	 VO and AdjN
Golin	 OV and NAdj
Gondi	 OV and AdjN
Gooniyandi	 OV and NAdj
Great Andamanese	 OV and NAdj
Grebo	 VO and NAdj
Greek (Modern)	 VO and AdjN
Greenlandic (West)	 OV and NAdj
Guajajara	 VO and NAdj
Guaraní	 VO and NAdj
Guarijío	 Other
Guató	 VO and NAdj
Gude	 VO and AdjN
Gugada	 OV and NAdj
Guhu-Samane	 OV and NAdj
Gujarati	 OV and AdjN
Gula (in Central African Republic)	 VO and NAdj
Gumawana	 OV and NAdj
Gumbaynggir	 Other
Gumuz	 Other
Gunbalang	 VO and AdjN
Gungbe	 VO and NAdj
Gunin	 Other
Gureng Gureng	 Other
Gurr-goni	 Other
Gurung	 OV and AdjN
Guugu Yimidhirr	 OV and NAdj
Gwari	 Other
Gyarong (Cogtse)	 OV and NAdj
Haida	 OV and NAdj
Halia	 VO and NAdj
Halkomelem (Upriver)	 VO and AdjN
Hamtai	 OV and NAdj
Hanga Hundi	 OV and AdjN
Hani	 Other
Haruai	 OV and NAdj
Hatam	 VO and NAdj
Hausa	 VO and AdjN
Hawaiian	 VO and NAdj
Haya	 VO and NAdj
Hayu	 OV and AdjN
Hdi	 VO and NAdj
Hebrew (Modern)	 VO and NAdj
Hehe	 VO and NAdj
Heiltsuk	 VO and AdjN
Hemba	 VO and NAdj
Hidatsa	 OV and NAdj
Hiligaynon	 Other
Hindi	 OV and AdjN
Hixkaryana	 OV and NAdj
Hlai (Baoding)	 VO and NAdj
Hmar	 OV and NAdj
Hmong Njua	 VO and NAdj
Ho	 OV and AdjN
Err:509	 VO and NAdj
Hoava	 VO and NAdj
Holoholo	 VO and NAdj
Hopi	 OV and AdjN
Hua	 OV and AdjN
Hualapai	 OV and NAdj
Huastec	 VO and AdjN
Huave (San Mateo del Mar)	 VO and AdjN
Huitoto (Minica)	 OV and AdjN
Huitoto (Murui)	 OV and AdjN
Hunde	 VO and NAdj
Hungarian	 VO and AdjN
Hunzib	 OV and AdjN
Hup	 OV and NAdj
Hupa	 Other
Iaai	 VO and AdjN
Iban	 VO and NAdj
Icelandic	 VO and AdjN
Idoma	 Other
Idu	 OV and AdjN
Iduna	 OV and NAdj
Ifira-Mele	 VO and NAdj
Ifugao (Batad)	 VO and AdjN
Ifumu	 VO and NAdj
Igbo	 VO and NAdj
Igede	 VO and NAdj
Ijo (Kolokuma)	 OV and AdjN
Ik	 VO and NAdj
Ika	 OV and NAdj
Ila	 VO and NAdj
Ilocano	 VO and AdjN
Imonda	 OV and NAdj
Inanwatan	 Other
Indonesian	 VO and NAdj
Ingessana	 VO and NAdj
Innamincka	 OV and NAdj
Iquito	 VO and NAdj
Iranxe	 OV and NAdj
Iraqw	 OV and NAdj
Irarutu	 VO and NAdj
Irish	 VO and NAdj
I'saka	 OV and NAdj
Italian	 VO and NAdj
Itelmen	 Other
Itonama	 Other
Iwaidja	 VO and AdjN
Iwoyo	 VO and NAdj
Izere	 VO and NAdj
Izi	 Other
Jabêm	 VO and NAdj
Jabutí	 OV and NAdj
Jad	 OV and NAdj
Jakaltek	 VO and AdjN
Jaminjung	 Other
Jamsay	 OV and NAdj
Japanese	 OV and AdjN
Jarawa (in Andamans)	 OV and NAdj
Jebero	 Other
Jingpho	 OV and NAdj
Jino	 OV and NAdj
Jivaro	 OV and AdjN
Johari	 OV and AdjN
Jugli	 Other
Ju|'hoan	 VO and NAdj
Jukun	 VO and NAdj
Jur Mödö	 VO and NAdj
Kabatei	 OV and AdjN
Kabiyé	 VO and NAdj
Kabyle	 VO and NAdj
Kachari	 Other
Kadazan	 VO and NAdj
Kagulu	 VO and NAdj
Kaingang	 OV and NAdj
Kairiru	 OV and NAdj
Kaki Ae	 OV and NAdj
Kalam	 OV and NAdj
Kalkatungu	 OV and NAdj
Kalmyk	 OV and AdjN
Kaluli	 OV and NAdj
Kamaiurá	 OV and NAdj
Kamasau	 OV and NAdj
Kamass	 OV and AdjN
Kamba	 VO and NAdj
Kambera	 VO and NAdj
Kambot	 OV and NAdj
Kamu	 Other
Kana	 Other
Kanakuru	 Other
Kannada	 OV and AdjN
Kanoê	 OV and NAdj
Kanuri	 OV and NAdj
Kapampangan	 Other
Karachay-Balkar	 OV and AdjN
Karadjeri	 Other
Kara (in Central African Republic)	 VO and NAdj
Karajá	 OV and NAdj
Karakalpak	 OV and AdjN
Karankawa	 Other
Karen (Bwe)	 VO and NAdj
Karen (Pwo)	 VO and NAdj
Karen (Sgaw)	 VO and NAdj
Karimojong	 VO and NAdj
Karkar-Yuri	 Other
Karó (Arára)	 OV and NAdj
Karok	 Other
Kashmiri	 VO and AdjN
Kasong	 VO and NAdj
Katcha	 VO and NAdj
Katla	 VO and NAdj
Kaulong	 VO and NAdj
Kawaiisu	 Other
Kayabí	 OV and NAdj
Kayah Li (Eastern)	 VO and NAdj
Kayardild	 Other
Kele	 VO and NAdj
Kemant	 OV and AdjN
Kera	 VO and NAdj
Ket	 OV and AdjN
Kete	 VO and NAdj
Kewa	 OV and AdjN
Khalaj	 OV and AdjN
Khaling	 OV and AdjN
Khalkha	 OV and AdjN
Kham	 OV and AdjN
Kham (Dege)	 OV and NAdj
Kham (Tibetan) (Nangchen)	 OV and NAdj
Khanty	 OV and AdjN
Khasi	 VO and NAdj
Khmer	 VO and NAdj
Khmu'	 VO and NAdj
Khowar	 OV and AdjN
Kikuyu	 VO and NAdj
Kilivila	 VO and NAdj
Kiliwa	 OV and NAdj
Kinga	 VO and NAdj
Kinnauri	 OV and AdjN
Kinyarwanda	 VO and NAdj
Kipea	 VO and NAdj
Kire	 OV and NAdj
Kiribati	 VO and NAdj
Kirma	 VO and NAdj
Kisi	 Other
Kiwai (Southern)	 OV and AdjN
Klamath	 Other
Klao	 Other
Klikitat	 VO and AdjN
Koasati	 OV and NAdj
Kobon	 OV and NAdj
Koegu	 VO and NAdj
Koiali (Mountain)	 OV and NAdj
Koita	 OV and NAdj
Kokborok	 OV and NAdj
Kokota	 VO and NAdj
Kolami	 OV and AdjN
Koluri	 OV and AdjN
Kombai	 OV and NAdj
Kombio	 VO and NAdj
Komi-Permyak	 OV and AdjN
Komi-Zyrian	 VO and AdjN
Komo	 VO and NAdj
Kongo	 VO and NAdj
Korana	 OV and AdjN
Korean	 OV and AdjN
Koreguaje	 VO and NAdj
Korku	 OV and AdjN
Koromfe	 VO and NAdj
Korowai	 OV and AdjN
Koryak	 OV and AdjN
Kosraean	 VO and NAdj
Koya	 OV and AdjN
Koyraboro Senni	 OV and NAdj
Koyra Chiini	 VO and NAdj
Koyukon	 OV and NAdj
Krahô	 OV and NAdj
Krenak	 OV and NAdj
Kresh	 VO and AdjN
Krongo	 VO and NAdj
Kryz	 OV and AdjN
Kugu Nganhcara	 OV and NAdj
Kuku-Yalanji	 OV and NAdj
Kulung	 OV and AdjN
Kuman	 OV and NAdj
Kumauni	 OV and AdjN
Kunama	 OV and NAdj
Kunimaipa	 OV and NAdj
Kuot	 VO and NAdj
Kurdish (Central)	 OV and NAdj
Kutenai	 Other
Kuuk Thaayorre	 OV and NAdj
Kuuku Ya'u	 OV and NAdj
Kuvi	 OV and AdjN
Kwaio	 VO and NAdj
Kwakw'ala	 VO and AdjN
Kwangali	 VO and NAdj
Kwaza	 OV and NAdj
Kwerba	 OV and NAdj
Kwoma	 OV and AdjN
Kwomtari	 Other
Kxoe	 OV and AdjN
Kyaka	 OV and NAdj
Kyirong	 OV and NAdj
Laal	 VO and NAdj
Labu	 VO and NAdj
Lacandón	 VO and AdjN
Ladakhi	 OV and NAdj
Lafofa	 Other
Lagwan	 VO and NAdj
Lahu	 Other
Lai	 Other
Lak	 OV and AdjN
Lakhota	 OV and NAdj
Lalo	 OV and NAdj
Lamaholot	 VO and NAdj
Lamang	 VO and NAdj
Lamani	 OV and AdjN
Lamen	 Other
Lampung	 VO and NAdj
Langi	 VO and NAdj
Lango	 VO and NAdj
Lao	 VO and NAdj
Laragia	 OV and NAdj
Latvian	 VO and AdjN
Lavukaleve	 OV and NAdj
Lebeo	 VO and NAdj
Leggbó	 VO and NAdj
Leko	 Other
Lele	 VO and NAdj
Lelemi	 VO and NAdj
Lenakel	 VO and NAdj
Lendu	 Other
Lepcha	 OV and NAdj
Lese	 Other
Leti	 VO and NAdj
Lewo	 VO and NAdj
Lezgian	 OV and AdjN
Lillooet	 VO and AdjN
Limbu	 OV and AdjN
Limilngan	 Other
Linda	 VO and AdjN
Lingala	 VO and NAdj
Lisu	 OV and NAdj
Lithuanian	 VO and AdjN
Logoti	 Other
Lokono	 VO and AdjN
Londo	 VO and NAdj
Longgu	 VO and NAdj
Loniu	 VO and NAdj
Lotha	 OV and NAdj
Lou	 VO and NAdj
Lucazi	 VO and NAdj
Lugbara	 Other
Luiseño	 Other
Lunda	 VO and NAdj
Lungchang	 Other
Luo	 VO and NAdj
Lusi	 VO and NAdj
Luvale	 VO and NAdj
Ma	 VO and AdjN
Ma'anyan	 VO and NAdj
Maasai	 VO and NAdj
Maba	 OV and NAdj
Macedonian	 VO and AdjN
Machiguenga	 Other
Macushi	 OV and NAdj
Mada (in Cameroon)	 VO and NAdj
Ma'di	 Other
Madimadi	 VO and AdjN
Mae	 VO and NAdj
Maidu (Northeast)	 OV and AdjN
Maipure	 VO and NAdj
Maisin	 OV and NAdj
Maithili	 OV and AdjN
Majang	 VO and AdjN
Makaa	 VO and NAdj
Makah	 Other
Makasae	 OV and NAdj
Makonde	 VO and NAdj
Makua	 VO and NAdj
Malagasy	 VO and NAdj
Malakmalak	 OV and NAdj
Malayalam	 OV and AdjN
Maleu	 VO and NAdj
Malgwa	 VO and NAdj
Malto	 OV and AdjN
Mam	 Other
Mamanwa	 Other
Mambila	 VO and NAdj
Mamvu	 VO and NAdj
Manadonese	 VO and NAdj
Manam	 OV and NAdj
Manange	 Other
Manchu	 OV and AdjN
Mandan	 OV and NAdj
Mandarin	 VO and AdjN
Mandinka (Gambian)	 OV and NAdj
Mangap-Mbula	 VO and NAdj
Mangarrayi	 OV and NAdj
Mangbetu	 VO and NAdj
Manggarai	 VO and NAdj
Mangghuer	 OV and AdjN
Maninka (Western)	 OV and NAdj
Mano	 OV and NAdj
Manobo (Western Bukidnon)	 VO and AdjN
Mansi	 OV and AdjN
Maori	 VO and NAdj
Mapudungun	 VO and AdjN
Mara	 Other
Maranungku	 OV and NAdj
Marathi	 OV and AdjN
Marchha	 OV and AdjN
Margi	 VO and NAdj
Maricopa	 OV and NAdj
Mari (Meadow)	 OV and AdjN
Maringarr	 OV and NAdj
Marquesan	 VO and NAdj
Marrithiyel	 OV and NAdj
Martuthunira	 VO and NAdj
Maru	 OV and NAdj
Masa	 VO and NAdj
Masakin	 VO and NAdj
Masalit	 OV and NAdj
Massachusett	 Other
Matis	 OV and NAdj
Matngele	 OV and NAdj
Matsés	 OV and NAdj
Matuumbi	 VO and NAdj
Mauka	 OV and NAdj
Maung	 VO and AdjN
Maybrat	 VO and NAdj
Mayogo	 VO and AdjN
Mazatec (Chiquihuitlán)	 VO and NAdj
Mazatec (Huautla)	 Other
Mba	 VO and NAdj
Mbara	 VO and NAdj
Mbay	 VO and NAdj
Mbere	 VO and NAdj
Mbili	 VO and NAdj
Mbodomo	 VO and AdjN
Mbole	 VO and NAdj
Mbosi	 VO and NAdj
Mbum	 VO and NAdj
Me'en	 VO and NAdj
Mehri	 VO and NAdj
Meithei	 Other
Mekens	 OV and NAdj
Mekeo	 OV and NAdj
Mende	 OV and NAdj
Menomini	 Other
Menya	 OV and NAdj
Meryam Mir	 OV and AdjN
Meyah	 VO and NAdj
Mian	 OV and NAdj
Mien	 VO and NAdj
Miisiirii	 OV and NAdj
Miju	 OV and NAdj
Mikir	 Other
Milang	 OV and AdjN
Mina	 VO and NAdj
Minangkabau	 Other
Minaveha	 OV and NAdj
Miriwung	 Other
Mising	 OV and AdjN
Miskito	 OV and NAdj
Miwok (Southern Sierra)	 Other
Mixe (Ayutla)	 Other
Mixtec (Chalcatongo)	 VO and NAdj
Mixtec (Jicaltepec)	 VO and NAdj
Mixtec (Ocotepec)	 VO and NAdj
Mixtec (Peñoles)	 VO and NAdj
Mixtec (Yosondúa)	 VO and NAdj
Miya	 VO and NAdj
Mizo	 OV and NAdj
Mlabri (Minor)	 VO and NAdj
Mocoví	 Other
Mofu-Gudur	 VO and NAdj
Mohawk	 Other
Mokilese	 VO and NAdj
Mon	 VO and NAdj
Mondunga	 VO and NAdj
Mongo	 VO and NAdj
Mono-Alu	 Other
Monumbo	 OV and NAdj
Mooré	 VO and NAdj
Mor	 VO and NAdj
Mordvin (Erzya)	 VO and AdjN
Moro	 VO and NAdj
Moru	 Other
Mosetén	 Other
Motu	 OV and NAdj
Motuna	 OV and NAdj
Mpongwe	 VO and NAdj
Mpur	 VO and NAdj
Mufian	 VO and NAdj
Muisca	 OV and NAdj
Mumuye	 VO and NAdj
Muna	 VO and NAdj
Mundang	 VO and NAdj
Mundari	 OV and AdjN
Mungaka	 VO and NAdj
Mupun	 VO and NAdj
Murle	 VO and NAdj
Murrinh-Patha	 OV and NAdj
Mursi	 VO and NAdj
Muruwari	 Other
Musgu	 VO and NAdj
Musom	 VO and NAdj
Musqueam	 VO and AdjN
Mussau	 VO and AdjN
Mwera	 VO and NAdj
Mwotlap	 VO and NAdj
Nabak	 OV and NAdj
Nadroga	 VO and NAdj
Naga (Mao)	 OV and NAdj
Naga (Tangkhul)	 OV and NAdj
Nagatman	 Other
Naga (Zeme)	 OV and NAdj
Nahuatl (Huasteca)	 VO and NAdj
Nahuatl (Michoacán)	 VO and NAdj
Nahuatl (North Puebla)	 Other
Nahuatl (Tetelcingo)	 VO and NAdj
Nai	 Other
Nakanai	 VO and NAdj
Nalik	 VO and NAdj
Nama	 OV and AdjN
Namia	 OV and NAdj
Nancowry	 VO and NAdj
Nandi	 VO and NAdj
Nankina	 OV and NAdj
Nara (in Ethiopia)	 OV and NAdj
Nar-Phu	 OV and NAdj
Nasioi	 Other
Natchez	 OV and NAdj
Nauruan	 VO and NAdj
Navajo	 OV and NAdj
Ncàm	 VO and NAdj
Ndebele	 VO and NAdj
Ndjébbana	 OV and NAdj
Ndonga	 VO and NAdj
Ndumu	 VO and NAdj
Ndut	 VO and NAdj
Ndyuka	 VO and AdjN
Nehan	 VO and NAdj
Nend	 OV and NAdj
Nenets	 OV and AdjN
Neo-Aramaic (Arbel Jewish)	 OV and NAdj
Nepali	 OV and AdjN
Nevome	 OV and AdjN
Newar (Dolakha)	 OV and AdjN
Newari (Kathmandu)	 OV and AdjN
Neyo	 Other
Nez Perce	 Other
Ngaanyatjarra	 OV and NAdj
Ngäbere	 OV and NAdj
Ngad'a	 VO and NAdj
Ngadjumaja	 OV and NAdj
Ngalakan	 Other
Ngalkbun	 OV and NAdj
Ngambay	 VO and NAdj
Nganasan	 OV and AdjN
Ngandi	 OV and NAdj
Ngan'gityemerri	 OV and NAdj
Ngankikurungkurr	 Other
Ngawun	 Other
Ngbandi	 VO and NAdj
Ngiti	 Other
Ngiyambaa	 Other
Ngizim	 VO and NAdj
Ngoni	 VO and NAdj
Nguna	 VO and NAdj
Nhanda	 Other
Nias	 VO and NAdj
Nicobarese (Car)	 VO and AdjN
Nisenan	 OV and AdjN
Nisgha	 VO and AdjN
Niuafo'ou	 VO and NAdj
Niuean	 VO and NAdj
Nivkh	 OV and AdjN
Nkem	 Other
Nkonya	 VO and NAdj
Nkore-Kiga	 VO and NAdj
Nocte	 OV and NAdj
Noghay	 OV and AdjN
Noni	 VO and NAdj
Noon	 VO and NAdj
Norwegian	 VO and AdjN
Nsenga	 VO and NAdj
Ntomba	 VO and NAdj
Nuaulu	 VO and NAdj
Nubian (Dongolese)	 OV and NAdj
Nubian (Kunuz)	 OV and NAdj
Nuer	 Other
Nunggubuyu	 Other
Nung (in Vietnam)	 VO and NAdj
Nuosu	 OV and NAdj
Nupe	 VO and NAdj
Nusu	 OV and NAdj
Nuuchahnulth	 Other
Nyamkad	 OV and NAdj
Nyamwezi	 VO and NAdj
Nyangumarda	 Other
Nyimang	 OV and NAdj
Nyishi	 OV and AdjN
Nzakara	 VO and AdjN
Obolo	 Other
Ocuilteco	 VO and AdjN
Ogbronuagum	 VO and AdjN
Oksapmin	 Other
Olo	 VO and NAdj
Omaha	 OV and NAdj
Ömie	 OV and NAdj
O'odham	 VO and AdjN
Ordos	 OV and AdjN
Orig	 OV and NAdj
Orok	 OV and NAdj
Orokaiva	 OV and NAdj
Oromo (Harar)	 OV and NAdj
Oromo (Waata)	 OV and NAdj
Orya	 OV and NAdj
Osage	 OV and NAdj
Ossetic	 OV and AdjN
Otomí (Mezquital)	 VO and AdjN
Otoro	 VO and NAdj
Pa'a	 VO and AdjN
Paakantyi	 VO and AdjN
Paamese	 VO and NAdj
Páez	 OV and NAdj
Paiute (Northern)	 OV and AdjN
Paiwan	 VO and NAdj
Palauan	 VO and AdjN
Palaung	 VO and NAdj
Palikur	 VO and NAdj
Pame	 VO and NAdj
Panará	 Other
Pangasinan	 Other
Pangwa	 VO and NAdj
Panjabi	 OV and AdjN
Panyjima	 Other
Pare	 VO and NAdj
Päri	 OV and NAdj
Pashto	 OV and AdjN
Patep	 VO and NAdj
Pattani	 OV and AdjN
Paulohi	 VO and NAdj
Paumarí	 Other
Pawaian	 OV and AdjN
Pero	 VO and NAdj
Persian	 OV and NAdj
Piaroa	 OV and NAdj
Pilagá	 VO and NAdj
Pima Bajo	 OV and AdjN
Pipil	 VO and AdjN
Pirahã	 OV and NAdj
Piro	 OV and NAdj
Pitjantjatjara	 OV and NAdj
Pitta Pitta	 Other
Podoko	 Other
Pohnpeian	 VO and NAdj
Poko-Rawo	 Other
Pokot	 VO and NAdj
Polish	 VO and AdjN
Port Sandwich	 VO and NAdj
Portuguese	 VO and NAdj
Prasuni	 OV and AdjN
Puluwat	 VO and NAdj
Pungupungu	 OV and NAdj
Purépecha	 VO and NAdj
Purki	 OV and AdjN
Qafar	 OV and AdjN
Quechua (Huallaga)	 OV and AdjN
Quechua (Imbabura)	 OV and AdjN
Quileute	 VO and AdjN
Raga	 VO and NAdj
Raji	 Other
Ralte	 OV and NAdj
Rama	 OV and NAdj
Rang Pas	 OV and AdjN
Rao	 OV and NAdj
Rapanui	 VO and NAdj
Rashad	 OV and NAdj
Rawa	 OV and NAdj
Rawang	 OV and NAdj
Remo	 OV and AdjN
Resígaro	 OV and AdjN
Retuarã	 OV and AdjN
rGyalrong (Caodeng)	 OV and NAdj
Ritharngu	 Other
Romanian	 VO and NAdj
Romani (Welsh)	 VO and AdjN
Romansch (Sursilvan)	 VO and NAdj
Ronga	 VO and NAdj
Rotuman	 VO and NAdj
Roviana	 VO and NAdj
Rukai (Tanan)	 Other
Rumu	 OV and NAdj
Runga	 OV and NAdj
Runyankore	 VO and NAdj
Runyoro-Rutooro	 VO and NAdj
Russian	 VO and AdjN
Rutul	 OV and AdjN
Saami (Northern)	 VO and AdjN
Sahu	 VO and NAdj
Sakao	 VO and NAdj
Saliba (in Papua New Guinea)	 OV and NAdj
Salinan	 Other
Salt-Yui	 OV and NAdj
Samba Leko	 VO and NAdj
Samoan	 VO and NAdj
Sandawe	 OV and NAdj
Sango	 VO and AdjN
Sangu	 VO and NAdj
Santa	 OV and AdjN
Santali	 OV and AdjN
Sanuma	 OV and NAdj
Sapuan	 VO and NAdj
Sarcee	 OV and NAdj
Sardinian	 VO and NAdj
Sare	 OV and AdjN
Savi	 OV and AdjN
Savosavo	 OV and AdjN
Sebei	 VO and NAdj
Sedang	 VO and NAdj
Seediq	 Other
Selknam	 OV and AdjN
Selkup	 OV and AdjN
Sema	 OV and NAdj
Seme	 OV and NAdj
Semelai	 VO and NAdj
Seminole	 OV and NAdj
Seneca	 Other
Sentani	 OV and NAdj
Serbian-Croatian	 VO and AdjN
Seri	 Other
Sesotho	 VO and NAdj
Shabo	 OV and AdjN
Shambala	 VO and NAdj
Shatt	 VO and NAdj
Sherpa	 OV and NAdj
Shilluk	 VO and NAdj
Shina	 OV and AdjN
Shipibo-Konibo	 Other
Shiriana	 OV and NAdj
Shompen	 VO and AdjN
Shona	 VO and NAdj
Shoshone	 OV and AdjN
Siane	 OV and NAdj
Siar	 VO and AdjN
Sidaama	 OV and AdjN
Sikkimese	 OV and NAdj
Sila	 OV and NAdj
Simeulue	 VO and NAdj
Sinaugoro	 OV and NAdj
Sinhala	 OV and AdjN
Sio	 VO and NAdj
Siona	 OV and AdjN
Sipakapense	 VO and AdjN
Sirionó	 OV and NAdj
Siroi	 OV and NAdj
Sisiqa	 VO and NAdj
Siuslaw	 VO and AdjN
Skou	 OV and NAdj
Slave	 OV and NAdj
Slovene	 VO and AdjN
So	 VO and NAdj
Sobei	 VO and NAdj
Soddo	 OV and AdjN
Somali	 OV and NAdj
Soninke	 OV and NAdj
Sonsorol-Tobi	 Other
Sorbian	 OV and AdjN
Sougb	 VO and NAdj
Southeast Ambrym	 VO and NAdj
Spanish	 VO and NAdj
Spitian	 OV and NAdj
Squamish	 VO and AdjN
Sre	 VO and NAdj
Stieng	 VO and NAdj
Sudest	 VO and NAdj
Suena	 OV and NAdj
Suki	 OV and AdjN
Suku	 VO and NAdj
Sulka	 VO and NAdj
Sundanese	 VO and NAdj
Supyire	 OV and NAdj
Swahili	 VO and NAdj
Swati	 Other
Swedish	 VO and AdjN
Taba	 VO and NAdj
Tabare	 OV and NAdj
Tabla	 OV and NAdj
Tabwa	 VO and NAdj
Tacana	 Other
Tagalog	 Other
Tahitian	 VO and NAdj
Taiof	 VO and NAdj
Tairora	 Other
Tajik	 OV and NAdj
Takelma	 OV and NAdj
Takia	 OV and NAdj
Talysh (Southern)	 OV and AdjN
Tama	 OV and NAdj
Tamabo	 VO and NAdj
Tamang (Eastern)	 OV and AdjN
Tamashek	 VO and NAdj
Tamil	 OV and AdjN
Tanacross	 OV and NAdj
Tarahumara (Central)	 OV and AdjN
Tarahumara (Western)	 OV and AdjN
Tarao	 OV and NAdj
Tariana	 Other
Tatana'	 VO and NAdj
Tatar	 OV and AdjN
Tausug	 VO and NAdj
Tauya	 OV and NAdj
Tawala	 OV and NAdj
Tboli	 VO and NAdj
Telefol	 OV and NAdj
Telugu	 OV and AdjN
Temein	 VO and NAdj
Temiar	 VO and NAdj
Temne	 VO and NAdj
Tennet	 VO and NAdj
Tenyer	 OV and NAdj
Teop	 VO and NAdj
Tepehua (Huehuetla)	 VO and AdjN
Tepehuan (Northern)	 Other
Tepehuan (Southeastern)	 VO and NAdj
Tepehua (Tlachichilco)	 VO and AdjN
Tera	 VO and NAdj
Teribe	 OV and NAdj
Teso	 VO and NAdj
Tetun	 VO and NAdj
Tetun Dili	 VO and NAdj
Thai	 VO and NAdj
Thakali	 OV and AdjN
Thangmi	 OV and AdjN
Thompson	 VO and AdjN
Thulung	 OV and AdjN
Tibetan (Dingri)	 OV and NAdj
Tibetan (Drokpa)	 OV and NAdj
Tibetan (Modern Literary)	 OV and NAdj
Tibetan (Shigatse)	 Other
Tibetan (Standard Spoken)	 OV and NAdj
Ticuna	 Other
Tidore	 VO and NAdj
Tigak	 VO and NAdj
Tigré	 OV and AdjN
Tigrinya	 OV and AdjN
Tiipay (Jamul)	 Other
Tikar	 Other
Tima	 VO and NAdj
Timugon	 VO and NAdj
Tinani	 OV and AdjN
Tinrin	 VO and AdjN
Tiv	 Other
Tiwa (Northern)	 Other
Tiwi	 VO and AdjN
Tlapanec	 VO and NAdj
Tlingit	 Other
Toba	 VO and AdjN
Tobati	 OV and NAdj
Tolai	 Other
Tondano	 VO and NAdj
Tonga (in Zambia)	 VO and NAdj
Tongan	 VO and NAdj
Tonkawa	 OV and NAdj
Torwali	 OV and AdjN
Totonac (Misantla)	 Other
Totonac (Xicotepec de Juárez)	 VO and AdjN
Trique (Copala)	 VO and NAdj
Trumai	 Other
Tsafiki	 OV and AdjN
Tsez	 OV and AdjN
Tshangla	 OV and AdjN
Tsimshian (Coast)	 VO and AdjN
Tsova-Tush	 OV and AdjN
Tubu	 OV and NAdj
Tucano	 Other
Tugun	 VO and NAdj
Tukang Besi	 VO and NAdj
Tulu	 OV and AdjN
Tumleo	 VO and NAdj
Tümpisa Shoshone	 OV and AdjN
Tunen	 OV and NAdj
Tungak	 VO and NAdj
Tunica	 OV and NAdj
Tupuri	 VO and NAdj
Turkana	 VO and NAdj
Turkish	 OV and AdjN
Turkmen	 OV and AdjN
Tuscarora	 Other
Tutsa	 Other
Tuvaluan	 OV and NAdj
Tuvan	 OV and AdjN
Tzutujil	 Other
Ubykh	 OV and AdjN
Udi	 OV and AdjN
Udihe	 OV and AdjN
Udmurt	 OV and AdjN
Ukrainian	 VO and AdjN
Uldeme	 VO and NAdj
Ulithian	 VO and NAdj
Una	 OV and NAdj
Ungarinjin	 OV and NAdj
Ura	 VO and NAdj
Uradhi	 OV and NAdj
Urak Lawoi'	 VO and NAdj
Urarina	 OV and NAdj
Urat	 VO and NAdj
Urdu	 OV and AdjN
Uru	 Other
Urubú-Kaapor	 OV and NAdj
Usan	 OV and NAdj
Usarufa	 OV and AdjN
Ute	 OV and NAdj
Uyghur	 OV and AdjN
Uzbek	 OV and AdjN
Vafsi	 OV and NAdj
Vai	 OV and NAdj
Venda	 VO and NAdj
Vietnamese	 VO and NAdj
Vinmavis	 VO and NAdj
Wagiman	 OV and NAdj
Wahgi	 OV and NAdj
Wakhi	 OV and AdjN
Walman	 VO and NAdj
Wambon	 OV and NAdj
Wambule	 OV and AdjN
Wan	 OV and NAdj
Wangkumara	 Other
Waorani	 Other
Wappo	 OV and NAdj
Warao	 OV and NAdj
Wardaman	 Other
Warekena	 VO and NAdj
Warembori	 VO and NAdj
Warlpiri	 Other
Warrgamay	 Other
Warrwa	 Other
Washo	 OV and AdjN
Waskia	 OV and NAdj
Wathawurrung	 VO and NAdj
Wedau	 OV and NAdj
Welsh	 VO and NAdj
Wembawemba	 VO and AdjN
West Makian	 VO and NAdj
Wichí	 VO and NAdj
Wichita	 OV and NAdj
Wikchamni	 Other
Wik Munkan	 OV and NAdj
Wik Ngathana	 OV and NAdj
Wintu	 Other
Wiyot	 Other
Woisika	 OV and NAdj
Wolaytta	 OV and AdjN
Woleaian	 VO and NAdj
Wolio	 VO and NAdj
Wolof	 VO and NAdj
Womo	 OV and NAdj
/Xam	 VO and NAdj
Xârâcùù	 VO and AdjN
Xasonga	 OV and NAdj
Xerénte	 OV and NAdj
Xhosa	 VO and NAdj
!Xóõ	 VO and NAdj
Yagaria	 OV and AdjN
Yagua	 VO and NAdj
Yahgan	 OV and AdjN
Yakut	 OV and AdjN
Yale (Kosarek)	 OV and NAdj
Yaminahua	 OV and NAdj
Yamphu	 OV and AdjN
Yao (in Malawi)	 VO and NAdj
Yapese	 VO and NAdj
Yaqui	 OV and AdjN
Yareba	 OV and AdjN
Yawuru	 Other
Yay	 VO and NAdj
Yelî Dnye	 OV and NAdj
Yidiny	 OV and NAdj
Yimas	 Other
Yindjibarndi	 Other
Yingkarta	 VO and AdjN
Yokuts (Yaudanchi)	 VO and AdjN
Yoruba	 VO and NAdj
Yuchi	 OV and NAdj
Yucuna	 VO and AdjN
Yukaghir (Kolyma)	 OV and AdjN
Yukaghir (Tundra)	 OV and AdjN
Yukulta	 OV and AdjN
Yulu	 VO and NAdj
Yup'ik (Central)	 Other
Yurok	 Other
Yuwaalaraay	 OV and AdjN
Zande	 VO and AdjN
Zapotec (Isthmus)	 VO and NAdj
Zapotec (Mitla)	 VO and NAdj
Zapotec (Yatzachi)	 VO and NAdj
Zapotec (Zoogocho)	 VO and NAdj
Zarma	 Other
Zayse	 OV and AdjN
Zazaki	 OV and NAdj
Zoque (Chimalapa)	 VO and AdjN
Zoque (Copainalá)	 VO and AdjN
Zulu	 VO and NAdj
Zuni	 OV and NAdj
